+++++++++++++++++++++++++
++     ++++  +++      +++
     +++      +++++++++++
+ +    ++        ++  ++++
+ +    ++    ++   ++    +
+ +          ++     +   +
++++++   ++  ++     +   +
++++++   ++++++  ++  ++ +
+           ++    + S + +
++++++++    +    +    + +
+++++++++++++++++++++++++